Erneuerung der Gemeindammänner im Bezirke Regensberg.
Mit Schreiben vom 27. v. M. berichtet das Statthalteramt Regensberg, daß die Erneuerungswahlen der Gemeindammänner des dortigen Bezirkes in gesetzlicher Form und Ordnung Statt gefunden und auf folgende Personen gefallen:
1.) Affoltern:	Herr	Jacob Bader.
2.) Bachs	“	Johannes Pfister.
3.) Buchs	“	Felix Maurer.  
4.) Dällikon	Herr	Jacob Meyer.
5.) Dielstorf	“	Jacob Hirs.
6.) Neerach	“	Hs. Jacob Schlatter.
7.) Niederhasle	“	Felix Schärer von Mettmenhasle.
8.) Niederweningen	“	Rudolf Wirth, Bezirksrath.
9.) Oberglatt	“	Johannes Maag.
10.) Oberweningen	“	Rudolf Surber.
11.) Otelfingen, Boppelsen u. Hüttikon	“	Johannes Schlatter, Lieutenant von Otelfingen.
12.) Regensberg	“	Hartmann Angst.
13.) Rümlang	“	Jacob Hinnen.
14.) Schleinikon, Dachslern u. Wasen	“	Jacob Merki von Dachslern.
15.) Schöfflistorf	“	Martin Meyer.
16.) Steinmaur	“	Heinrich Schmid von Obersteinmaur.
17.) Weyach	“	Jacob Baumgartner.
(Die Wahlen für Stadel und Regenstorf sind noch nicht vorgenommen.)
Von diesen Wahlen wird im Protokoll Vormerkung gemacht und dem Finanzrathe, an welchen die Bürgschaftsscheine einlangen sollen, Kenntniß gegeben.
