Schrbn a. d. schweiz. Bundesrath betr. Einsendung der zürch. Geschworenenliste die eidg. Strafrechtspflege.
Der Regierungsrath hat nachdem die sämmtlichen Kirchgemeinden des Kantons die Wahlen der Geschworenen für die eidgenößische Strafrechtspflege nach Vorschrift des Gesetzes vom 30 August d. J. über die Bildung der zürcherischen Geschworenenliste für die eidgen. Strafrechtspflege, beendigt haben und die sämmtlichen Wahlen von den Bezirksräthen als gültig anerkannt worden sind,
in Vollziehung des Artikel 29 des Bundes-  gesetzes vom 5 Juni d. Js. über Organisation der Bundesrechtspflege; 
beschloßen:
Es ist die hiesige Kantonalgeschworenenliste dem Bundesrathe zu übermitteln.
[l. M. v. h. T] 
Verzeichniß
Der Zürcherischen Geschworenen für die eidgenößische Strafrechtspflege.
Bezirk Zürich.
Albisrieden	Salomon Haller, Hauptmann.
Altstetten	J. Wehrli, Major.
Außersihl	J. R. Wunderli, Kriminalgerichter.
Birmenstorf	Joh. Gut, Gemeindammann.
Dietikon	Wiederkehr, Gemeindrath.
Enge u. Leimbach Heinrich Arter.
“				Kaspar Boßhard, Zunftrichter.
Fluntern		Heinrich Rordorf, alt Präsident
Höngg			H. Rieder, Bezirksrichter.
“				H. Zweifel, Med. Dr 
Neumünster	J. Hotz, Präsident von Hirslanden.
“				J. J. Bleuler, alt Oberrichter v. Riesbach.
“				J. Tuggener, Gemeindsschreiber von Riesbach.
“				Steiner-Freitag von Hottingen.
Oberstraß		Heinr. Keller, Gemeindammann.
Schlieren		Rudolf Haug Schulpfleger.
Schwamendingen Jakob Hotz, Notar.
Seebach	Jakob Meier, alt Gemeindammann.  
Uitikon		J. Wismer, alt Präsident.
Unterstraß	Rud. Zangger, Präsident.
Urdorf		Heinrich Lips, Gemeindammann v. Niederurdorf.
Weiningen	Kaspar Benz von Geroldschweil.
“			Bernhard Schmid von Oetweil.
Wiedikon	Jakob Salzmann Arzt.
Wipkingen	Kaspar Vontobel Bezirksrath.
Wollishofen	Daniel Boßhard.
Wytikon		H. Lang, Gemeindammann.
Zollikon		Hch. Heußer, alt Kantonsrath.
Zürich		Hch. Gysi, Stadtschreiber.
“			Ad. Bürkli, Artilleriehauptmann.
“			G. von Wyß alt Staatschreiber.
“			Arnold Escher von der Linth.
“			Fr. Sal. Ott, Stadtrath.
“			alt Statthalter Konr. von Wyß.
“			Bernhard Spyri, Prokurator.
“			C. Rahn-Escher. Med Dr
“			D. Rahn, alt Staatsanwalt.
“			Kasp. Hirzel, alt Regierungsrath.
“			Karl Wolf, Flachmaler.
Bezirk Affoltern.
Augst		Jakob Spinner, Bezirksrath.
Affoltern	J. Heinr. Schneebeli, Bezirksrichter
“			Kleiner, Gemeindammann.
Bonstetten	J. J. Bühler, Med Dr Bezirksrichter.
Hausen		Fr. Hegi, Bezirksrichter.  
Hedingen	J. H. Frei, Bezirksgerichtsschreiber.
Kappel		J. J. Hurter, alt Präsident.
Knonau		Gottlieb Syz, Präsident.
Maschwanden	Studer, Zunftrichter.
Mettmenstetten	J. Huber Gemeindammann.
Obfelden	Jakob Gut, alt Gemeindammann.
Ottenbach	Jakob Hegetschweiler Bezirksrath.
Rifferschweil	Rudolf Huber, Präsident.
Stallikon	Hr. Bühler, Gemeindammann in Wettschweil.
Bezirk Horgen
Horgen		Heinr. Stapfer, Gemeindammann, am Thalacker.
“			Johs. Burkhardt, Friedensrichter, am Platz.
“			Johs. Stapfer, Major, im Neuhaus.
Hirzel		Rud. Strickler, Friedensrichter im Forrenmoos.
Hütten		Jakob Schärrer, Sekelmeister in Örischwand.
Kirchberg
mit Adlischweil	Johs. Scheller, Hauptmann, im Schooren.
“			J. Günthard, Präsident, zum Grundstein in Adlischweil.
Langnau	Walder, Pfleger, auf der Hehl.
Oberrieden	Hch. Welti, Friedensrichter b. d. Kirche.
Richterschweil	Johannes Schmid Dr  
“			Heinr. Landis, Hauptmann.
“			Johs. Pister, alt Präsident.
Rüschlikon	Gut-Rellstab.
Schönenberg	Heinrich Schärrer, Vater zum Rößli.
Thalweil	J. Jak. Kölliker, alt Statthalter.
“			Jakob Staub Dr, Kantonsrath.   
Wädenschweil	Karl Hauser zur Gerwe.
“			Rud. Hotz, Kantonsrath.
“			Kasp. Rellstab, Präsident.
“			Theiler-Ulrich, Erziehungsrath.
Bezirk Meilen.
Hombrechtikon	Hr. Hürlimann, alt Kantonsrath im Feldbach.
“				Hr. Bühler, Zunftrichter im Lueholz.
Stäfa			Daniel Heiz im Spittel.
“				J. L. Bühler, Oberstlieut. in Uerikon.
“				Werner Kunz, Hauptmann in Oetikon.
Oetweil			Heinr. Stauber, Kantonsrath in der Gusch.
Männedorf		J. J. Billeter, Kantonsrath im Oberdorf.
“				Rud. Diener, alt Kantonsrath, im Außerfeld.
Uetikon			J. J. Leemann, Gemeindrathspräsident im Langenbach.
Meilen			Jak. Leemann, Schützmeister in Hofstetten.
“				Johs. Knopfli, alt Friedensrichter im Feld.
“				Heinr. Wunderli, Hauptmann in der Bruggen.
Herrliberg		C. Bruppacher, Gemeindrathspräsident am See.
Erlenbach		Wirz, alt Schulverwalter im Lindschädler.
Küßnacht		J. Fierz, Oberst.
“				J. R. Brunner, Med Dr 
Zumikon		Kasp. Bertschinger, Armenpfleger.
Bezirk Hinweil.
Bärentschweil	Stößel Civilpräsident, im Scheuerli.
“				Raths, Bezirksrathsweibel in Bärentschweil.
“				Hs. Jakob Walder, Kantonsrath.  
Bubikon		J. Hch. Hottinger, Gemeindammann.
Dürnten			J. J. Meier Gemeindammann in Edikon.
Fischenthal		Heinrich Spörri, Gemeindammann im Schmittenbach.
“				J. Jakob Ruegg, Gemeindrath im Alt-Hörnli.
Goßau			Weber, alt Gemeindrath im Schwabshof.
“				Marx Bebie, Zunftrichter in Bertschikon.
“				Hs. Jakob Briner, Friedensrichter in Goßau.
Grüningen		Kaspar Dürsteler, Gemeindammann und Präsident in Itzikon.
Hinweil			Bachmann, Gemeindrathspräsident.
“				Nauer Friedensrichter.
Rüti				Marx Vontobel Civilpräsident in Rüti.
Wetzikon u.
Seegräber		Rud. Hirzel, Lieutnant in Wolfershausen.
“				Rud. Weber, alt Bezirksgerichtsschreiber in Wetzikon.
“				Johs. Hirzel, Gemeindammann und Zunftgerichtsschreiber in Seegräben.
Wald			Pfenninger, Friedensrichter, Steigwaid.
“				Martin, Sekundarlehrer in Wald.
“				Hoffmann, Landschreiber.
Bezirk Uster.
Dübendorf		J. Hch. Zollinger, Kantonsrath.
“				Hs. Jak. Zollinger, Gemeindammann.
Egg				Hs. Kasp. Stiefel, Friedensrichter in Hinteregg.  
Egg				Jakob Boller, Gemeindrathspräsident in Hinteregg.
Fällanden		Heinr. Wunderli, Bezirksrichter.
Greifensee		Wilhelm Dietrich, Landschreiber.
Maur			Hch. Trüb, Bezirksrichter.
“				Konr. Hotz, Friedensrichter.
Mönchaltorf		Joh. Rud. Muggli, Gemeindrathsschreiber.
Schwerzenbach	Hs. Hch. Pfister, Sohn.
Uster			Heinr. Homberger, Major.
“				J. Pfenninger, Bezirksrathsschreiber.
“				J. Ehrismann, Bezirksgerichtsschreiber.
“				Gujer Gemeindrathspräsident.
Volkentschweil	Hch. Meier, Schuster, in Volkentschweil.
“				Hch. Meier Schulpfleger in Zimikon.
Wangen		Johs. Jucker, Gemeindrathsschreiber.
Bezirk Pfäffikon
Pfäffikon		Johannes Boßhard, Gemeindammann in Irgenhausen.
“				Johannes Stucki Lieutnant in Bußenhausen.
“				J. Rudolf Näf, alt Kantonsrath in Pfäffikon.
Hittnau			Hs. Jakob Boßhard, Hauptmann in Balchenstall.
“				Heinrich Strehler, Zunftrichter in Unter-Hittnau.
Bauma			Hch. Ruegg Med Dr von Bauma, in Zürich.   
Bauma			Hs. Jakob Ruegg, Gemeindrath, zur alten Mühle in Bauma.
“				Johs. Kappeler, Hauptmann in Bauma.
Sternenberg	J. Konr. Bachmann, Lehrer in Sternenberg.
Wyla			Salomon Lüßi, Gemeindammann in Wyla.
Wildberg		Jakob Binder, Gemeindrathspräsident.
Weißlingen		Josua Greutert, Notariatssubstitut von Weißlingen, in Kyburg.
Kyburg			Joh. Jak. Scheuchzer, alt Landschreiber von Feuerthalen in Kyburg.
Rußikon		Hs. Heinrich Schneider, Schulpfleger in der Bläsimühle.
“				Konrad Schellenberg, Kirchenpfleger in Russikon.
Lindau			Hs. Ulrich Wegmann, Lieutnant in Tagelschwangen.
Illnau			Rud. Wegmann, alt Kantonsrath in Würglen.
“				J. J. Wintsch, Gemeindrathspräsident in Rykon b. Illnau.
Fehraltorf		Heinr. Boßhard, Quartierskommandant von Rüti, in Fehraltorf.
Bezirk Winterthur.
Altikon			F. Brunner, Gemeindrathspräsident.
Bertschikon		Rudolf Schellenberg, zur Krone in Gudetschweil.  
Brütten			Graf, Oberstlieutnant, im Seefeld.
Dägerlen.		Rudolf Keller, Gemeindrathspräsident von Benk.
Dättlikon		Jakob Weidmann, Gemeindammann.
Dynhard		Ulrich Müller, Bezirksrath von Welzikon.
Elgg mit 
Hofstetten		Werner Ott, Zunftrichter von Elgg.
und Schottikon	Heinrich Mantel, Kantonsrath von Elgg.
Ellikon			C. R. Egg Gemeindrathspräsident.
Hagenbuch-
Schneit			Jakob Wettstein, Gemeindrathspräsident in Ober-Schneit.
Hettlingen		Johs. Müller, Schulpfleger.
Neftenbach		Heinr. Ziegler-Hirzel, Hauptmann.
Oberwinterthur	Jak. Furrer Gemeindrathspräsident.
“				F. Ehrensperger Gemeindammann.
Pfungen		Jak. Steiner, Friedensrichter in Rumsthal.
Schlatt			Salomon Jucker, Gemeindammann in Unter-Schlatt.
Seen			Jak. Jäggli, Gemeindrathspräsident.
Seuzach		G. Ackeret, Gemeindammann.
Töß				Hch. Ernst, Gemeindrathspräsident.
Turbenthal		J. Wolf, Kantonsrath.
“				Hch. Boßhard, Zunftrichter.
Veltheim		J. Wiesendanger, Gemeindrathspräsident.
Wiesendangen	J. Wuhrmann, Bezirksrichter.  
Winterthur		R. Wäffler-Egli, Kantonsrath.
“				H. Geilinger zur Arch.
“				H. Biedermann, Stabshauptmann zur Geduld.
“				Jb. Weber, Zunftrichter.
Wülflingen		K. S. von Clais, Oberstlieutnat im Hard.
“				Jak. Boßhard, Gemeindspräsident.
Zell				Rud. Bär, Müller in Rykon.
“				J. Hch. Schwarz, Sohn.
Bezirk Andelfingen.
Andelfingen		Konrad Hanhardt, Hauptmann.
“				Konrad Himmel, Gemeindrathspräsident in Klein-Andelfingen.
Benken			J. U. Meister, Bezirks- u. Kantonsrath.
Berg			Hch. Kramer, Präsident von Grüßlikon.
Buch			Abraham Müller, Gemeindammann.
Dorf			Jos. Bretscher, Zunftrichter.
Dorlikon		Hch. Morf, Gemeindrath.
Feuerthalen		J. Hch. Bleuler, Oberstlieut.
Flaach			Jak. Hatt Lieut. v. Volken.
Henggart		Jonas Frauenfelder, Zunftgerichtsschreiber.
Lauffen			J. J. Schenk, Quartiermeister von Uhwiesen.
Marthalen		Georg Nägeli Gemeindrathspräsident.
Oßingen		Johannes Keller, Bezirksrichter von Hausen.
Rheinau		K. Ignaz Schweizer, Landschreiber.
Stammheim		Jak. Gyrsperger, Lieut. in Unter-Stammheim  
Stammheim		Ulr. Müller, Landschreiber in Ober-Stammheim.
Trüllikon		Hch. Peter, Gemeindrathspräsident.
Bezirk Bülach.
Baßerstorf		Felix Weiß, Friedensrichter.
“				Schellenberg, alt Zunftrichter von Oberweil.
Bülach			David Kern, Bezirksrathsschreiber.
“				Johs. Nägeli, Kreisschätzer.
“				Rudolf Schmid, Eichmeister.
Dietlikon		Johs. Kuhn von Dietlikon.
Eglisau			Jak. Lauffer, Prokurator.
“				Konr. Hartmann, Oberstlieut.
Embrach		August Unholz Med Dr
“				Felix Klöti, Friedensrichter in Augweil.
Glattfelden		Hartmann Keller, Reallehrer.
Kloten			Hch. Schäppi, Landschreiber.
“				Jakob Schweizer, Gemeindammann in Opfikon.
Lufingen		Hch. Ruegg, Gemeindammann.
Rafz			Sal. Neukomm, Gemeindrathspräsid.
Rorbaß			Karl Ganz Dr
Wyl				Ulrich Demuth, Seckelmeister in Hüntwangen.
“				Konr. Heller, Seckelmeister in Wyl.
Bezirk Regensberg
Affoltern		Jak. Bader, Kantonsrath.  
Bachs			Rud. Meier, Hauptmann in der Thalmühle
Buchs			Rud. Müller Zunftrichter.
Dällikon			H. Meier, Bezirksthierarzt.
Dielstorf		Hch. Benz Major
Niederhasli		Konrad Bänninger, Landschreiber in Niederglatt.
Niederweningen	Fel. Weidmann Med Dr
Oberglatt		Hs. Jak. Maag, Gemeindrath.
Otelfingen		Johannes Honegger, Arzt von Hombrechtikon, in Otelfingen, (vide 
				Beschlüße d. Reg. Rathes v. 22 Jan. u. 5 März d. Js.)
Regensberg	Hartmann Krauer, alt Regierungsrath.
Regenstorf		Jak. Stäubli, Bezirksrichter.
Rümlang		Johs. Meier cand. jur.
Stadel			Jak. Hauser, Arzt.
Steinmaur		Heinr. Schmid, Gemeindammann in Obersteinmaur.
“				Jakob Albrecht, Friedensrichter in Neerach.
Schöfflistorf		Andr. Haarlacher, alt Präsident.
Weiach			Hs. Heinrich Willi, Kantonsrath und Gemeindammann.
